wwwwwwwwwwwwwwwwwwwwwwwwww
w-x-------x-w-A----x-----w
w---x-------w------------w
w-----------w------------w
w------x----w------------w
w----x------w------------w
w----------------x-------w
w-----------x------------w
w--x--------------------xw
wwwwwwwwwwwwwwwwwwwwwww--w
w--------------------x---w
w------------------------w
wwwwwwwwwwwwwwwwwwwwwwweww