wwwwwwwwwwwwwwwwwwwwwwwwww
w-----c------------------w
w------------------------w
w------------------------w
w------------------------w
w------------------c-----w
w------------------------w
w-------------A----------w
w------------------------w
w------------------------w
w------------------------w
w------------------------w
wwwwwwwwwwwwwwwwwwwwwwwwwe